1111111111111111111111111111111111111111
1P000000000000000000C0C00000000000000E01
1000000000000000000000000000000000000001
1M000000000000000000000000000000000000M1
100000000BBBB00BBBB00BBBB00BBBB000000001
100000000BC0B00000B00000B00B00B000000001
100000000B00B0000MB00000B00B00B000000001
100000000B00B00SSSB00SSSB00000B000000001
100000000000B0000CB00000B00000B000000001
1000M0000000B00000B00000B00000B000000BB1
100C000000WWWW0BBBB00BBBB00000B000000B01
1111111111111111111111111111111111111111